111111111111111111111
1CCCCCCCCC1CCCCCCCCC1
1C111C111C1C111C111C1
1C111C111C1C111C111C1
1CCCCCCCCCCCCCCCCCCC1
1C111C1C11111C1C111C1
1CCCCC1CCC1CCC1CCCCC1
11111C111C1C111C11111
11111C1CCCCCCC1C11111
11111C1C11011C1C11111
1KCCCCCC10P01CCCCCCE1
11111C1C11111C1C11111
11111C1CCCCCCC1C11111
11111C1C11111C1C11111
1CCCCCCCCC1CCCCCCCCC1
1C111C111C1C111C111C1
1CCC1CCCCCCCCCCC1CCC1
111C1C1C11111C1C1C111
1CCCCC1CCC1CCC1CCCCC1
1C1111111C1C1111111C1
1CCCCCCCCCCCCCCCCCCC1
111111111111111111111
