1111111111111
10C10000C0001
1000011111001
1P0011E000001
1111111111111
