11111111111111111111111111111
10000010000000001000000010001
10111010111111101011111010101
100C101000100010101000101C101
11111011111010101011101011101
1P000010001010101000001010001
11111010101110101111111010101
10000010100000001000000000101
10111011101111101011101111101
10101000001000101010101000101
10101111111011101010101011111
10001000001000001000100010001
10101010111011111010101010111
1010101000101C000010101000001
10101011101011111111101111111
10101010101000000000100000101
10101010100011111110101110101
10101110111110000010100010001
10100000000010111010111011101
10111010100C10001010000000101
10100010111111111010111110101
101011100000100010101000101C1
10101011111010101000101110111
10001010001000101010100000001
11111010101010101010111111111
10000000101010100010000000001
10111111101110110111101111011
1000000E1000001000100000100C1
11111111111111111111111111111
